INSERT STORY HERE.

TheHauntedHouse
An Interactive Fiction by Dylan Vodzak
Release 1 / Serial number 141014 / Inform 7 build 6L38 (I6/v6.33 lib 6/12N) SD

Front Yard

>n
Main Room

>n
You can't go that way.

>n
You can't go that way.

>e
Spooky Bedroom

>e
You can't go that way.

>w
Extended Long Hallway

>n
You can't go that way.

>s
The Long Hallway
You can see a Crooked Stairs here.

>close crooked stairs
You close the Crooked Stairs.

* * *

>n
You can't go that way.

I beg your pardon?

* * *

>n
You can't go that way.

>open door
You can't see any such thing.

>open
What do you want to open?

>open the crooked stairs
You can't see any such thing.

>up
You can't go that way.

>no
That was a rhetorical question.

>n
You can't go that way.

>e
Spooky Library

>e
You can't go that way.

>w
Main Room

>w
Spooky Family Room

>w
You can't go that way.

>n
You can't go that way.

>w
You can't go that way.

>e
Main Room

>n
You can't go that way.

* * *

I beg your pardon?

>n
You can't go that way.

>open doo
You can't see any such thing.